XXXXXXXXXXXXXXXXXX
X                X
X   X        X   X
X      .         X
X   XX   *  XX   X
X   o            X
X   X   XXX   .  X
X   o  XX   o    X
X  XXX   B  XXX  X
X     .      o   X
XXXXXXXXXXXXXXXXXX

