XXXXXXXXXXXXXXXXXX
X                X
X   #        #   X
X                X
X   ##      ##   X
X                X
X   #   ###      X
X      ##        X
X  ###      ###  X
X                X
XXXXXXXXXXXXXXXXXX